For	ADP
many	ADJ
Americans	PROPN
,	PUNCT
presidential	ADJ
elections	NOUN
essentially	ADV
end	VERB
when	SCONJ
a	DET
candidate	NOUN
is	AUX
declared	VERB
the	DET
winner	NOUN

This	DET
year	NOUN
,	PUNCT
after	ADP
several	ADJ
days	NOUN
of	ADP
tense	ADJ
waiting	NOUN
and	CCONJ
watching	VERB
,	PUNCT
The	DET
Associated	PROPN
Press	PROPN
called	VERB
the	DET
presidential	ADJ
race	NOUN
Saturday	PROPN
morning	NOUN
,	PUNCT
declaring	VERB
that	SCONJ
former	ADJ
Vice	PROPN
President	PROPN
Joe	PROPN
Biden	PROPN
will	AUX
become	VERB
the	DET
46th	ADJ
president	NOUN
of	ADP
the	DET
United	PROPN
States	PROPN

He	PRON
secured	VERB
his	PRON
win	NOUN
with	ADP
crucial	ADJ
victories	NOUN
in	ADP
swing	NOUN
states	NOUN
such	ADJ
as	ADP
Wisconsin	PROPN
,	PUNCT
Pennsylvania	PROPN
and	CCONJ
Michigan	PROPN

His	PRON
running	NOUN
mate	NOUN
,	PUNCT
SenKamala	PROPN
Harris	PROPN
of	ADP
California	PROPN
,	PUNCT
will	AUX
make	VERB
history	NOUN
as	ADP
the	DET
first	ADJ
Black	ADJ
woman	NOUN
and	CCONJ
the	DET
first	ADJ
Asian	ADJ
American	ADJ
woman	NOUN
to	PART
be	AUX
elected	VERB
vice	NOUN
president	NOUN

But	CCONJ
the	DET
journey	NOUN
from	ADP
candidate	NOUN
to	ADP
president	NOUN
-	PUNCT
elect	NOUN
,	PUNCT
and	CCONJ
then	ADV
president	NOUN
,	PUNCT
is	AUX
not	PART
quite	ADV
complete	ADJ

There	PRON
are	VERB
still	ADV
a	DET
number	NOUN
of	ADP
important	ADJ
steps	NOUN
yet	ADV
to	PART
play	VERB
out	ADP
from	ADP
November	PROPN
through	ADP
January	PROPN

